NAUGHTY DOG - Dog Simulator 2015
PUZZLE SOLVER - Life is Strange Ep4 Pt 5
Would You Rather? - Minecraft
HIPPY LOVE- Kitty Powers Matchmaker Ep 9
ASS KICKIN - Life is Strange Ep4 Pt 4
IT'S TROPICRAFT! - Cloud 9 Season 3 Ep. 5
BACK TO LIFE - Life is Strange Ep4 Pt 3
RED'S MAKEOVER - Make Over App Games
PULLING THE PLUG? - Life is Strange Ep4 Pt 2
MASTERPIECE  - Pixel Painters - Minecraft Mini Game
A NEW LIFE - Life is Strange Ep4 Pt 1
IN MY HOME?! - Five Nights at Freddys 4
Funny Moments Montage 2! - iHasCupquake
THE SEARCH FOR THE PINEAPPLE- Cloud 9 Season 3 Ep. 4
HORSING AROUND - Horse Simulator App Game
STARTING TO MAKE SOME MONEY!  - Sims 3 Ever After Ep 9
FAT SUITS BATTLE - Gang Beast - Husband vs Wife
WE'RE ALL ARTIST - Pixel Painters - Minecraft Mini Game
I ARE ARTIST - Minecraft Draw it!
SAUSAGE FACTORY- Kitty Powers Matchmaker Ep 8
BACK TO THE BASICS - Cloud 9 Season 3 Ep. 3
3 Addictive Apps
SOMEONE BECOMES A CELEBRITY - Sims 3 Ever After Ep 8
MOUSE HOUSE? - Minecraft Build Battle
FANTABULOUS - Makeover app Games
Minecon 2015 - Vlog
BEAUTIFUL DAY FOR DEATH - Cloud 9 Season 3 Ep. 2
CAT-TASTIC! - Kitty App Games!
FINDING A DISCO HOUSE - UHShe Ep  7
I'M EXPECTED TO DIE?! Oculus Rift
WITCH ENCOUNTER - UHShe Ep  6
MEOW! - Kitty App game
RUNNING FROM THE WALL - UHShe Ep  5
BUNS AND BURGERS - Citizen Burger Disorder Animated
UDDERS ON FIRE - Udder App game
SEARCHING FOR DIAMONDS - UHShe Ep  4
Minecraft Creeper Pudding Desserts - Quake n Bake
GOLD RUSH - UHShe Ep  3
PUNKED BY A CHICKEN - Gang Beast
EPIC LAVA CAVES - UHShe Ep  2
A NEW, DANGEROUS WORLD - Cloud 9 Season 3
BACK IN THE GAME - Minecraft UHShe Ep 1
MY HAPPY PLACE - Animal Crossing New Leaf
POSTERS UPDATE, CLOUD 9 & NEW WEBSITE
RED'S NEW BEST FRIEND - Sims 3 Ever After Ep 7
MY FIRST KICK - Kitty Powers Matchmaker Ep 7
BIG BUTTS - Husband vs Wife
MMM HOT DATE?!
MINECON, POSTERS, & MOAR!
A GREAT START - The Long Dark Ep 16
